5555555555555555555555555555555555555555555555555555555555555555555555 
5555555555555555555555555555555555555555555555555555555555555555555555 
5522222221112222222221112222222221112222222221112222222221112222222255 
5521111111112111111111112111111111112111111121112111111121112111111155
5521111111312111111111112111111111112111111121112111111121112111111155 
5521111111312111111111112111111111112111111121112111411121112111111155 
5521111133312111111111112114111111112111411121112111111121112111111155 
5521111111312111111111112111111111112111111121112111111121112111114155 
5521111411312111111111112111111411112111111121112111111121112111111155
5521111111312111111111112111111111112111111121112111111121112111111155 
5522221111312222222221112111111111112122222121112122222221112222211155 
5521111111311111111121112111111111112111111121112111111111112111111155 
5521111111311111111121112111111111112133333121112131111111112111111155 
5521141111311111411121112111111111112111311121112131111111112111111155 
5521111111311111111121112111111111112111311121112131111111112111111155 
5521113333333333311121112111111111112111311121112131111111112111111155 
5521111111311111111121112111111111112111311121112131111111112111411155 
5521111111311111111121112114111111112111311121112131111111112111111155 
5521111111311111111121112111111111112111311121112131111111112111111155 
5521111111311111111121112111111111112111311121112131111111112111111155 
5521111111311111111121112111111111312111311121112131111111112111111155
5522222221312222222221112222222221312111311121112131111111112222222155 
5511111111311111111111111111111111311111311111111131111111111111111155 
5513333333333333333333333333333333333333333333333333333333333333333155 
5511111111111111111111311111111111311111111111111111111111111111111155 
5511111111112222222221312222222221312222322221112222111222211111111155 
5511411111112111111111312111111121312111311121112112111211211111111155
5511111111112111111111312111111121312111311121112112111211211111411155 
5511111141112111111111312111111121312111311121112112111211211111111155 
5511111111112114111111312114111121312111311121112112111211211111111155 
5511111111112114111111312111111121312111311121112112222211211111111155
5511333331112111111111312111111121312111311121112111111111211113331155 
5511355531112111111111312111111121312111311121112111111111211133533155 
5511355531112111111141312111111121312111311121112111114111211135553155 
5511353531112222211111312212222221333333333331112111111111211135553155 
5511355531112111111111312111121111312111311121112111111111211135553155 
5511355531112111111111312111121111312111311121112111111111211133533155 
5511333331112111111111312111121111312111311121112114111111211113331155 
5511111111112111111111312111121111312111311121112111111111211111111155 
5511111111112111111111312111121111312111311121112111111111214111111155 
5511111111112111411111312111121111312111311121112111111111211111111155 
5514111111112111111111312111121111312111311121112111111111211111111155 
5511111111112111111111312111121111312111311121112111111411211111411155 
5511111141112111111111312111121111312111311121112111111111211111111155 
5511111111112111111111312111121111312111311121112111111111211111111155 
5511111111112111111111312111121111312222322221112111111111211111111155 
5511111111111111111111311111111111311111111111111111111111111111111155
5513333333333333333333333333333333333333333333333333333333333333333155 
5511111111111131111111111113111111111111311111111111131111111111113155 
5511122222222131222222222213122222222221312222222222131222222222213155 
5511121111111131211111111213121111111121312111111112131211111111213155 
5511121114111131211111111213121111111121312111111111131211111111113155 
5511121111111131111111111113111141111111312111111111131211111111113155
5511121111111131211141111213121111111121312111141111131211113333333155
5511121133333331211111111213121111111121312111111111131211111111111155
5511121111111111211111111213121111111121312111111111131211111114111155 
5511121111111111211111111213121111111121312111111111131211111111111155
5511121111111111212222222213121222222121312222222222131222222222211155 
5511121111111111211111211113121111111121311111111112131111111111211155
5511121111111111211111211113121111111121311111111112131111111111211155 
5511126122222111211111211113121111111121311111111112131111411111211155
5511121111112111211111211113121111111121311111111112131111111111211155 
5511121111112111211111113333121111111121333333311112133333333111211155
5511121111112111211411211111121111111121111111111112111111111111211155 
5511121114112111211111211111121111141121111141111112111111111111211155
5511121111112111211111211111121111111121111111111112111111111111211155
5511121111112111211111211111121111111121112111111112111211111111211155
5511122222222111211111211111121111111121112222222222111222222222214155
5555555555555555555555555555555555555555555555555555555555555555555555 
5555555555555555555555555555555555555555555555555555555555555555555555
